97
03
111E111
1110111
1000101
1010100
1110111
1000001
1011101
1011001
0111011
